start_date,sample_size,population,candidate,approve,disapprove,total
2020-02-02,1500,a,Trump,42,29,71
2020-02-07,2200,a,Trump,57,22,79
2020-02-07,684,a,Trump,88,4,92
2020-02-07,817,a,Trump,37,37,74
2020-02-07,700,a,Trump,50,22,72
2020-02-07,1996,rv,Trump,39,35,74
2020-02-07,700,rv,Trump,71,8,79
2020-02-07,788,rv,Trump,15,60,75
2020-02-09,1500,a,Trump,39,28,67
2020-02-09,607,a,Trump,33,25,58
2020-02-16,1500,a,Trump,39,32,71
2020-02-23,1500,a,Trump,39,31,70
2020-02-24,2200,a,Trump,54,27,81
2020-02-24,737,a,Trump,84,7,91
2020-02-24,786,a,Trump,29,49,78
2020-02-24,677,a,Trump,49,24,73
2020-02-26,2592,rv,Trump,48,52,100
2020-02-26,848,rv,Trump,82,18,100
2020-02-26,925,rv,Trump,22,78,100
2020-02-26,735,rv,Trump,46,54,100
2020-02-26,1000,a,Trump,45,38,83
2020-02-28,2201,a,Trump,48,35,83
2020-02-28,694,a,Trump,84,7,91
2020-02-28,814,a,Trump,23,61,84
2020-02-28,692,a,Trump,41,33,74
2020-03-01,1500,a,Trump,37,47,84
2020-03-01,622,a,Trump,11,80,91
2020-03-01,618,a,Trump,34,41,75
2020-03-02,1115,a,Trump,38,47,85
2020-03-02,2593,a,Trump,47,48,95
2020-03-02,1128,a,Trump,86,13,99
2020-03-02,1053,a,Trump,16,82,98
2020-03-03,1990,rv,Trump,44,42,86
2020-03-03,675,rv,Trump,79,9,88
2020-03-03,769,rv,Trump,15,72,87
2020-03-04,1211,a,Trump,41,48,89
2020-03-05,1261,rv,Trump,43,49,92
2020-03-06,1000,rv,Trump,42,49,91
2020-03-06,2200,a,Trump,42,43,85
2020-03-06,658,a,Trump,81,10,91
2020-03-06,809,a,Trump,16,72,88
2020-03-06,733,a,Trump,36,41,77
2020-03-08,1001,rv,Trump,47,53,100
2020-03-08,1500,a,Trump,42,43,85
2020-03-09,1113,a,Trump,39,49,88
2020-03-09,1541,lv,Trump,42,58,100
2020-03-10,1635,a,Trump,41,46,87
2020-03-10,659,a,Trump,35,44,79
2020-03-10,1000,a,Trump,44,43,87
2020-03-10,2200,a,Trump,43,42,85
2020-03-10,693,a,Trump,83,11,94
2020-03-10,754,a,Trump,16,74,90
2020-03-10,753,a,Trump,34,41,75
2020-03-11,900,rv,Trump,45,51,96
2020-03-11,1000,rv,Trump,42,45,87
2020-03-12,850,a,Trump,46,46,92
2020-03-13,835,a,Trump,44,49,93
2020-03-13,784,rv,Trump,45,49,94
2020-03-13,1015,rv,Trump,50,50,100
2020-03-13,1000,a,Trump,44,43,87
2020-03-13,1986,rv,Trump,41,51,92
2020-03-13,677,rv,Trump,79,14,93
2020-03-13,761,rv,Trump,10,84,94
2020-03-13,1986,rv,Trump,47,43,90
2020-03-13,677,rv,Trump,83,10,93
2020-03-13,761,rv,Trump,18,73,91
2020-03-13,1020,a,Trump,60,38,98
2020-03-14,2050,a,Trump,51,49,100
2020-03-14,659,a,Trump,85,15,100
2020-03-14,779,a,Trump,26,74,100
2020-03-15,1500,a,Trump,45,46,91
2020-03-16,1115,a,Trump,47,47,94
2020-03-16,1100,a,Trump,41,55,96
2020-03-16,995,rv,Trump,41,55,96
2020-03-17,613,a,Trump,56,44,100
2020-03-17,2019,a,Trump,56,44,100
2020-03-17,662,a,Trump,86,14,100
2020-03-17,1851,rv,Trump,53,39,92
2020-03-17,614,rv,Trump,87,9,96
2020-03-17,725,rv,Trump,26,64,90
2020-03-17,744,a,Trump,28,72,100
2020-03-18,1100,rv,Trump,49,41,90
2020-03-18,1000,a,Trump,51,40,91
2020-03-18,851,a,Trump,50,45,95
2020-03-18,4428,a,Trump,49,44,93
2020-03-18,1680,a,Trump,83,13,96
2020-03-18,1981,a,Trump,24,71,95
2020-03-19,2300,a,Trump,89,12,101
2020-03-19,11537,a,Trump,48,51,99
2020-03-19,1000,lv,Trump,45,54,99
2020-03-19,6474,a,Trump,18,81,99
2020-03-19,2300,a,Trump,59,42,101
2020-03-19,2800,a,Trump,34,66,100
2020-03-19,8000,a,Trump,59,41,100
2020-03-19,4738,a,Trump,83,17,100
2020-03-20,2200,a,Trump,49,40,89
2020-03-20,709,a,Trump,85,7,92
2020-03-20,690,a,Trump,42,45,87
2020-03-20,1996,rv,Trump,42,52,94
2020-03-20,659,rv,Trump,81,16,97
2020-03-20,758,rv,Trump,14,81,95
2020-03-20,1000,a,Trump,49,42,91
2020-03-20,1000,rv,Trump,52,44,96
2020-03-20,1038,rv,Trump,52,42,94
2020-03-20,800,a,Trump,25,67,92
2020-03-21,2023,a,Trump,55,45,100
2020-03-21,661,a,Trump,87,13,100
2020-03-21,699,a,Trump,32,68,100
2020-03-21,663,a,Trump,50,50,100
2020-03-21,2190,a,Trump,53,47,100
2020-03-21,693,a,Trump,22,78,100
2020-03-21,706,a,Trump,54,47,101
2020-03-21,1011,rv,Trump,51,46,97
2020-03-21,1012,rv,Trump,52,43,95
2020-03-21,2343,a,Trump,51,49,100
2020-03-22,1002,rv,Trump,56,44,100
2020-03-22,1500,a,Trump,48,44,92
2020-03-22,1500,a,Trump,45,55,100
2020-03-22,1003,a,Trump,51,45,96
2020-03-22,1003,rv,Trump,48,48,96
2020-03-23,1500,rv,Trump,46,37,83
2020-03-23,1005,rv,Trump,49,49,98
2020-03-23,1000,lv,Trump,53,45,98
2020-03-24,1000,a,Trump,53,44,97
2020-03-24,2410,rv,Trump,50,50,100
2020-03-24,782,rv,Trump,83,17,100
2020-03-24,903,rv,Trump,24,76,100
2020-03-24,647,rv,Trump,47,53,100
2020-03-24,2410,rv,Trump,44,56,100
2020-03-24,782,rv,Trump,78,22,100
2020-03-24,903,rv,Trump,18,82,100
2020-03-24,647,rv,Trump,40,60,100
2020-03-24,2200,a,Trump,50,41,91
2020-03-24,689,a,Trump,85,11,96
2020-03-24,782,a,Trump,22,72,94
2020-03-24,729,a,Trump,47,38,85
2020-03-24,889,lv,Trump,49,51,100
2020-03-24,1022,rv,Trump,47,50,97
2020-03-24,601,a,Trump,53,42,95
2020-03-25,1579,a,Trump,43,49,92
2020-03-25,1017,rv,Trump,49,48,97
2020-03-25,659,a,Trump,40,44,84
2020-03-25,1226,a,Trump,50,47,97
2020-03-25,2000,a,Trump,51,49,100
2020-03-25,765,a,Trump,18,83,101
2020-03-26,948,rv,Trump,50,50,100
2020-03-26,1845,lv,Trump,45,55,100
2020-03-26,1057,a,Trump,44,55,99
2020-03-26,1213,lv,Trump,48,52,100
2020-03-26,600,a,Trump,43,33,76
2020-03-26,2300,a,Trump,88,12,100
2020-03-26,2560,a,Trump,52,48,100
2020-03-26,2800,a,Trump,25,74,99
2020-03-26,2300,a,Trump,49,51,100
2020-03-26,8000,a,Trump,53,47,100
2020-03-26,1017,rv,Trump,48,48,96
2020-03-27,2200,a,Trump,49,41,90
2020-03-27,694,a,Trump,85,11,96
2020-03-27,827,a,Trump,22,69,91
2020-03-27,679,a,Trump,48,38,86
2020-03-27,1997,rv,Trump,43,51,94
2020-03-27,651,rv,Trump,82,13,95
2020-03-27,770,rv,Trump,14,82,96
2020-03-27,1009,a,Trump,50,43,93
2020-03-27,1000,a,Trump,50,45,95
2020-03-27,1010,rv,Trump,48,48,96
2020-03-28,1505,a,Trump,44,51,95
2020-03-28,602,a,Trump,43,49,92
2020-03-28,2219,a,Trump,47,53,100
2020-03-29,1500,a,Trump,50,42,92
2020-03-29,1226,a,Trump,43,41,84
2020-03-30,1114,a,Trump,48,46,94
2020-03-30,1008,rv,Trump,48,49,97
2020-03-31,825,a,Trump,20,75,95
2020-03-31,683,a,Trump,42,45,87
2020-03-31,2236,a,Trump,51,49,100
2020-03-31,708,a,Trump,18,83,101
2020-03-31,703,a,Trump,52,48,100
2020-03-31,2200,a,Trump,48,45,93
2020-03-31,997,rv,Trump,47,49,96
2020-03-31,692,a,Trump,85,11,96
2020-04-01,1000,rv,Trump,47,44,91
2020-04-01,1003,rv,Trump,48,49,97
2020-04-02,1200,lv,Trump,45,55,100
2020-04-02,933,rv,Trump,49,51,100
2020-04-02,2077,rv,Trump,46,51,97
2020-04-02,706,rv,Trump,12,86,98
2020-04-02,644,rv,Trump,43,53,96
2020-04-02,1007,rv,Trump,48,48,96
2020-04-02,8000,a,Trump,45,48,93
2020-04-02,2300,a,Trump,80,16,96
2020-04-02,2800,a,Trump,20,74,94
2020-04-02,2300,a,Trump,32,47,79
2020-04-03,1000,a,Trump,50,44,94
2020-04-03,1003,rv,Trump,51,49,100
2020-04-03,2200,a,Trump,49,45,94
2020-04-03,684,a,Trump,88,11,99
2020-04-03,804,a,Trump,50,45,95
2020-04-03,1002,a,Trump,45,52,97
2020-04-03,823,a,Trump,20,75,95
2020-04-03,857,a,Trump,46,49,95
2020-04-03,693,a,Trump,44,43,87
2020-04-03,1990,rv,Trump,40,54,94
2020-04-03,704,rv,Trump,76,18,94
2020-04-03,763,rv,Trump,10,86,96
2020-04-03,1022,rv,Trump,50,47,97
2020-04-04,1107,rv,Trump,51,48,99
2020-04-04,1905,a,Trump,47,53,100
2020-04-05,1500,a,Trump,46,47,93
2020-04-05,1018,rv,Trump,48,48,96
2020-04-06,668,a,Trump,43,45,88
2020-04-06,1116,a,Trump,42,53,95
2020-04-06,1000,a,Trump,48,50,98
2020-04-06,1566,a,Trump,42,50,92
2020-04-06,1002,lv,Trump,53,45,98
2020-04-06,5167,a,Trump,54,44,98
2020-04-06,1901,a,Trump,91,8,99
2020-04-06,2259,a,Trump,22,78,100
2020-04-06,871,a,Trump,51,47,98
2020-04-07,2025,a,Trump,47,52,99
2020-04-07,696,a,Trump,15,85,100
2020-04-07,1005,rv,Trump,48,48,96
2020-04-07,1718,a,Trump,45,55,100
2020-04-08,1200,rv,Trump,48,49,97
2020-04-08,1006,rv,Trump,46,50,96
2020-04-08,1001,a,Trump,47,53,100
2020-04-09,1003,rv,Trump,47,50,97
2020-04-09,8000,a,Trump,45,48,93
2020-04-09,2300,a,Trump,81,16,97
2020-04-09,2800,a,Trump,18,77,95
2020-04-09,2300,a,Trump,32,46,78
2020-04-10,770,rv,Trump,11,86,97
2020-04-10,1000,a,Trump,50,44,94
2020-04-10,2854,rv,Trump,50,50,100
2020-04-10,913,rv,Trump,84,16,100
2020-04-10,1056,rv,Trump,24,76,100
2020-04-10,828,rv,Trump,45,55,100
2020-04-10,2200,a,Trump,45,48,93
2020-04-10,700,a,Trump,82,11,93
2020-04-10,1004,rv,Trump,51,49,100
2020-04-10,855,a,Trump,18,75,93
2020-04-10,645,a,Trump,42,43,85
2020-04-10,1990,rv,Trump,42,52,94
2020-04-10,693,rv,Trump,83,13,96
2020-04-10,1015,rv,Trump,47,50,97
2020-04-11,1600,a,Trump,42,54,96
2020-04-11,640,a,Trump,42,53,95
2020-04-11,1712,a,Trump,48,52,100
2020-04-12,1500,a,Trump,45,47,92
2020-04-12,603,a,Trump,43,45,88
2020-04-13,1111,a,Trump,48,48,96
2020-04-13,1349,lv,Trump,44,56,100
2020-04-13,900,rv,Trump,44,52,96
2020-04-13,1000,rv,Trump,46,54,100
2020-04-13,1011,rv,Trump,46,52,98
2020-04-14,939,a,Trump,47,48,95
2020-04-14,2394,rv,Trump,51,49,100
2020-04-14,818,rv,Trump,84,16,100
2020-04-14,877,rv,Trump,23,77,100
2020-04-14,629,rv,Trump,48,52,100
2020-04-14,997,rv,Trump,45,51,96
2020-04-14,1013,a,Trump,44,54,98
2020-04-14,1016,a,Trump,50,48,98
2020-04-14,1893,a,Trump,47,53,100
2020-04-15,1000,lv,Trump,49,50,99
2020-04-15,1006,rv,Trump,44,52,96
2020-04-15,4429,a,Trump,44,52,96
2020-04-16,1012,rv,Trump,43,53,96
2020-04-16,8000,a,Trump,46,47,93
2020-04-16,2300,a,Trump,81,15,96
2020-04-16,2800,a,Trump,20,75,95
2020-04-16,1057,a,Trump,41,58,99
2020-04-16,2300,a,Trump,34,44,78
2020-04-17,1178,lv,Trump,46,54,100
2020-04-17,2200,a,Trump,48,45,93
2020-04-17,734,a,Trump,83,11,94
2020-04-17,789,a,Trump,19,77,96
2020-04-17,676,a,Trump,42,43,85
2020-04-17,1000,a,Trump,46,46,92
2020-04-17,1597,a,Trump,45,49,94
2020-04-17,610,a,Trump,43,45,88
2020-04-17,1100,a,Trump,43,47,90
2020-04-17,1022,rv,Trump,42,54,96
2020-04-17,6418,a,Trump,36,41,77
2020-04-17,22921,a,Trump,40,44,84
2020-04-17,7335,a,Trump,83,8,91
2020-04-17,8252,a,Trump,17,67,84
2020-04-18,1991,rv,Trump,40,53,93
2020-04-18,678,rv,Trump,80,16,96
2020-04-18,774,rv,Trump,11,82,93
2020-04-18,1000,lv,Trump,45,52,97
2020-04-18,1800,a,Trump,45,55,100
2020-04-18,630,a,Trump,19,81,100
2020-04-18,653,a,Trump,43,57,100
2020-04-19,1917,rv,Trump,49,49,98
2020-04-19,775,rv,Trump,85,15,100
2020-04-19,910,rv,Trump,20,78,98
2020-04-19,958,rv,Trump,51,49,100
2020-04-19,1500,a,Trump,45,45,90
2020-04-19,607,a,Trump,39,44,83
2020-04-20,674,a,Trump,52,48,100
2020-04-20,1010,rv,Trump,43,53,96
2020-04-20,2112,a,Trump,48,52,100
2020-04-20,647,a,Trump,14,86,100
2020-04-21,998,a,Trump,45,50,95
2020-04-21,1035,rv,Trump,44,52,96
2020-04-21,1000,rv,Trump,45,52,97
2020-04-21,1008,a,Trump,44,55,99
2020-04-21,851,rv,Trump,42,57,99
2020-04-21,1008,a,Trump,47,52,99
2020-04-21,621,a,Trump,18,82,100
2020-04-21,644,a,Trump,45,55,100
2020-04-21,1500,rv,Trump,42,43,85
2020-04-21,1774,a,Trump,47,53,100
2020-04-22,1031,rv,Trump,44,53,97
2020-04-23,1012,rv,Trump,44,53,97
2020-04-23,8000,a,Trump,43,49,92
2020-04-23,2300,a,Trump,81,16,97
2020-04-23,2800,a,Trump,16,80,96
2020-04-23,2300,a,Trump,32,48,80
2020-04-24,2200,a,Trump,43,49,92
2020-04-24,681,a,Trump,83,13,96
2020-04-24,834,a,Trump,15,77,92
2020-04-24,685,a,Trump,37,50,87
2020-04-24,1991,rv,Trump,41,53,94
2020-04-24,794,rv,Trump,10,81,91
2020-04-24,1000,a,Trump,46,47,93
2020-04-24,670,rv,Trump,83,15,98
2020-04-24,1004,rv,Trump,43,54,97
2020-04-25,1274,lv,Trump,41,59,100
2020-04-25,1795,a,Trump,46,54,100
2020-04-25,628,a,Trump,21,79,100
2020-04-25,652,a,Trump,40,60,100
2020-04-26,1200,rv,Trump,39,51,90
2020-04-26,1500,a,Trump,44,49,93
2020-04-26,1225,a,Trump,41,39,80
2020-04-27,1000,rv,Trump,43,49,92
2020-04-27,8086,a,Trump,43,56,99
2020-04-27,2216,a,Trump,42,53,95
2020-04-27,1008,rv,Trump,45,53,98
2020-04-27,2264,a,Trump,84,16,100
2020-04-27,2830,a,Trump,12,88,100
2020-04-27,2911,a,Trump,40,58,98
2020-04-28,1049,a,Trump,45,50,95
2020-04-28,1022,rv,Trump,46,52,98
2020-04-28,1005,a,Trump,44,56,100
2020-04-28,623,a,Trump,19,81,100
2020-04-28,646,a,Trump,37,63,100
2020-04-28,1779,a,Trump,43,57,100
2020-04-29,1014,rv,Trump,46,52,98
2020-04-29,10957,a,Trump,41,59,100
2020-04-30,8000,a,Trump,42,51,93
2020-04-30,2300,a,Trump,79,18,97
2020-04-30,2800,a,Trump,15,82,97
2020-04-30,808,a,Trump,42,51,93
2020-04-30,1005,rv,Trump,44,54,98
2020-04-30,2300,a,Trump,32,45,77
2020-05-01,1489,lv,Trump,44,56,100
2020-05-01,2200,a,Trump,41,48,89
2020-05-01,670,a,Trump,81,14,95
2020-05-01,852,a,Trump,13,73,86
2020-05-01,678,a,Trump,35,51,86
2020-05-01,1000,a,Trump,45,46,91
2020-05-01,1014,rv,Trump,43,55,98
2020-05-02,1987,rv,Trump,39,53,92
2020-05-02,687,rv,Trump,76,19,95
2020-05-02,804,rv,Trump,10,80,90
2020-05-02,1546,a,Trump,40,54,94
2020-05-02,618,a,Trump,40,52,92
2020-05-02,1670,a,Trump,44,57,101
2020-05-02,606,a,Trump,40,61,101
2020-05-03,1500,a,Trump,44,48,92
2020-05-04,1215,a,Trump,43,50,93
2020-05-04,1573,a,Trump,42,52,94
2020-05-04,602,a,Trump,38,52,90
2020-05-04,1010,rv,Trump,44,54,98
2020-05-05,916,a,Trump,42,53,95
2020-05-05,1022,rv,Trump,46,52,98
2020-05-05,1007,a,Trump,46,54,100
2020-05-05,1681,a,Trump,45,55,100
2020-05-05,610,a,Trump,42,58,100
2020-05-06,957,rv,Trump,52,48,100
2020-05-06,1020,rv,Trump,45,52,97
2020-05-07,1112,a,Trump,42,55,97
2020-05-07,1009,rv,Trump,43,53,96
2020-05-07,8000,a,Trump,44,49,93
2020-05-07,2300,a,Trump,77,19,96
2020-05-07,2800,a,Trump,20,76,96
2020-05-07,2300,a,Trump,32,43,75
2020-05-08,1000,a,Trump,42,48,90
2020-05-08,1500,rv,Trump,37,47,84
2020-05-08,2200,a,Trump,42,49,91
2020-05-08,690,a,Trump,80,16,96
2020-05-08,791,a,Trump,14,76,90
2020-05-08,719,a,Trump,35,51,86
2020-05-08,1994,rv,Trump,37,54,91
2020-05-08,658,rv,Trump,79,16,95
2020-05-08,771,rv,Trump,9,81,90
2020-05-08,1010,rv,Trump,41,55,96
2020-05-09,632,a,Trump,20,80,100
2020-05-09,1807,a,Trump,44,56,100
2020-05-09,656,a,Trump,41,59,100
2020-05-10,1500,a,Trump,45,49,94
2020-05-11,1112,a,Trump,41,54,95
2020-05-11,2000,a,Trump,43,57,100
2020-05-11,641,a,Trump,12,87,99
2020-05-11,621,a,Trump,42,58,100
2020-05-11,1010,rv,Trump,41,56,97
2020-05-12,817,a,Trump,44,50,94
2020-05-12,657,a,Trump,38,63,101
2020-05-12,1011,rv,Trump,42,56,98
2020-05-12,1811,a,Trump,42,58,100
2020-05-12,634,a,Trump,18,82,100
2020-05-13,950,rv,Trump,50,50,100
2020-05-13,1189,a,Trump,46,52,98
2020-05-13,619,rv,Trump,79,21,100
2020-05-13,683,rv,Trump,24,76,100
2020-05-13,1854,rv,Trump,46,54,100
2020-05-14,1323,rv,Trump,41,56,97
2020-05-14,1056,a,Trump,39,60,99
2020-05-14,2300,a,Trump,79,17,96
2020-05-14,2800,a,Trump,16,80,96
2020-05-14,2300,a,Trump,28,46,74
2020-05-14,8000,a,Trump,42,50,92
2020-05-15,1424,lv,Trump,45,55,100
2020-05-15,1995,rv,Trump,44,51,95
2020-05-15,694,rv,Trump,84,12,96
2020-05-15,785,rv,Trump,11,84,95
2020-05-15,1000,a,Trump,45,47,92
2020-05-15,1011,rv,Trump,40,56,96
2020-05-15,1994,rv,Trump,37,58,95
2020-05-15,640,rv,Trump,78,19,97
2020-05-15,764,rv,Trump,6,89,95
2020-05-16,631,a,Trump,20,81,101
2020-05-16,654,a,Trump,37,63,100
2020-05-16,1802,a,Trump,43,57,100
2020-05-17,1500,a,Trump,42,50,92
2020-05-17,1207,rv,Trump,43,55,98
2020-05-17,1100,a,Trump,41,51,92
2020-05-18,1115,a,Trump,42,52,94
2020-05-18,1000,lv,Trump,41,56,97
2020-05-19,933,a,Trump,43,55,98
2020-05-19,658,a,Trump,37,63,100
2020-05-19,1814,a,Trump,43,57,100
2020-05-19,635,a,Trump,18,82,100
2020-05-20,733,a,Trump,39,60,99
2020-05-20,1640,a,Trump,40,53,93
2020-05-20,1003,a,Trump,49,51,100
2020-05-20,4429,a,Trump,41,53,94
2020-05-21,1000,rv,Trump,44,48,92
2020-05-21,1012,rv,Trump,41,55,96
2020-05-21,2200,a,Trump,43,50,93
2020-05-21,724,a,Trump,81,13,94
2020-05-21,761,a,Trump,12,84,96
2020-05-21,715,a,Trump,38,50,88
2020-05-21,1000,lv,Trump,47,52,99
2020-05-21,3404,a,Trump,42,57,99
2020-05-21,2800,a,Trump,19,76,95
2020-05-21,8000,a,Trump,42,49,91
2020-05-21,2300,a,Trump,78,17,95
2020-05-21,2300,a,Trump,29,49,78
2020-05-21,1200,rv,Trump,44,53,97
2020-05-22,1000,a,Trump,42,52,94
2020-05-22,785,rv,Trump,7,90,97
2020-05-22,643,rv,Trump,79,20,99
2020-05-22,1986,rv,Trump,36,59,95
2020-05-23,1500,a,Trump,45,50,95
2020-05-23,649,a,Trump,44,47,91
2020-05-23,1822,a,Trump,43,57,100
2020-05-23,638,a,Trump,17,83,100
2020-05-23,661,a,Trump,40,61,101
2020-05-25,1001,a,Trump,46,53,99
2020-05-26,1824,a,Trump,42,58,100
2020-05-26,638,a,Trump,17,83,100
2020-05-26,662,a,Trump,35,65,100
2020-05-26,833,a,Trump,43,51,94
2020-05-28,807,a,Trump,42,56,98
2020-05-28,1000,rv,Trump,43,55,98
2020-05-28,1007,rv,Trump,42,57,99
2020-05-28,8000,a,Trump,42,51,93
2020-05-28,2300,a,Trump,78,19,97
2020-05-28,2800,a,Trump,17,79,96
2020-05-28,2300,a,Trump,34,50,84
2020-05-28,1034,a,Trump,42,58,100
2020-05-29,2200,a,Trump,40,51,91
2020-05-29,704,a,Trump,77,17,94
2020-05-29,727,a,Trump,11,85,96
2020-05-29,769,a,Trump,33,51,84
2020-05-29,1981,rv,Trump,36,59,95
2020-05-29,637,rv,Trump,78,19,97
2020-05-29,2071,a,Trump,45,55,100
2020-05-29,658,a,Trump,13,87,100
2020-05-29,629,a,Trump,43,57,100
2020-05-29,1060,a,Trump,43,53,96
2020-05-29,1457,lv,Trump,44,56,100
2020-05-29,1000,a,Trump,42,51,93
2020-05-29,778,rv,Trump,9,87,96
2020-05-30,1780,a,Trump,39,61,100
2020-05-30,623,a,Trump,15,85,100
2020-05-30,646,a,Trump,30,70,100
2020-05-31,1500,a,Trump,41,52,93
2020-05-31,1233,a,Trump,38,46,84
2020-06-01,1113,a,Trump,40,54,94
2020-06-01,1327,a,Trump,41,54,95
2020-06-01,5703,a,Trump,45,52,97
2020-06-01,2374,a,Trump,87,13,100
2020-06-01,2458,a,Trump,9,90,99
2020-06-01,745,a,Trump,38,60,98
2020-06-02,1259,a,Trump,41,56,97
2020-06-02,1707,a,Trump,41,59,100
2020-06-02,620,a,Trump,35,65,100
2020-06-03,706,a,Trump,39,60,99
2020-06-04,1608,rv,Trump,41,56,97
2020-06-04,675,rv,Trump,9,89,98
2020-06-04,2800,a,Trump,13,82,95
2020-06-04,2300,a,Trump,28,48,76
2020-06-04,8000,a,Trump,41,53,94
2020-06-04,2300,a,Trump,78,18,96
2020-06-05,2200,a,Trump,38,55,93
2020-06-05,680,a,Trump,79,17,96
2020-06-05,806,a,Trump,10,87,97
2020-06-05,714,a,Trump,31,55,86
2020-06-05,1000,a,Trump,43,50,93
2020-06-06,1992,rv,Trump,34,61,95
2020-06-06,629,rv,Trump,76,22,98
2020-06-06,753,rv,Trump,6,90,96
2020-06-06,610,rv,Trump,26,65,91
2020-06-06,635,a,Trump,39,61,100
2020-06-06,1748,a,Trump,43,57,100
2020-06-06,612,a,Trump,17,84,101
2020-06-07,855,rv,Trump,44,53,97
2020-06-07,1500,a,Trump,44,50,94
2020-06-08,1912,rv,Trump,47,53,100
2020-06-08,611,rv,Trump,83,17,100
2020-06-08,707,rv,Trump,20,80,100
2020-06-08,1114,a,Trump,43,52,95
2020-06-08,1500,rv,Trump,37,51,88
2020-06-08,25052,a,Trump,35,63,98
2020-06-08,169420,a,Trump,45,53,98
2020-06-08,64866,a,Trump,87,13,100
2020-06-08,75498,a,Trump,8,91,99
2020-06-09,1642,a,Trump,45,55,100
2020-06-09,1570,a,Trump,41,55,96
2020-06-09,836,a,Trump,41,54,95
2020-06-10,4426,a,Trump,40,55,95
2020-06-11,1310,a,Trump,37,62,99
2020-06-11,1009,rv,Trump,40,57,97
2020-06-11,1332,rv,Trump,42,56,98
2020-06-11,8000,a,Trump,40,54,94
2020-06-11,2800,a,Trump,13,84,97
2020-06-11,2300,a,Trump,27,50,77
2020-06-11,2300,a,Trump,78,19,97
2020-06-12,867,a,Trump,13,80,93
2020-06-12,726,a,Trump,32,55,87
2020-06-12,1987,rv,Trump,37,58,95
2020-06-12,654,rv,Trump,78,20,98
2020-06-12,722,rv,Trump,7,88,95
2020-06-12,607,a,Trump,78,17,95
2020-06-12,1000,a,Trump,39,52,91
2020-06-12,611,rv,Trump,27,62,89
2020-06-12,1000,lv,Trump,41,57,98
2020-06-12,1250,lv,Trump,42,58,100
2020-06-12,2200,a,Trump,37,55,92
2020-06-13,1000,rv,Trump,41,48,89
2020-06-13,1343,rv,Trump,44,55,99
2020-06-13,631,rv,Trump,12,87,99
2020-06-14,1500,a,Trump,40,51,91
2020-06-17,1886,rv,Trump,44,56,100
2020-06-17,1337,rv,Trump,38,58,96
2020-06-17,706,rv,Trump,22,78,100
2020-06-17,727,a,Trump,41,58,99
2020-06-17,1100,a,Trump,37,58,95
2020-06-18,1995,rv,Trump,38,55,93
2020-06-18,1313,rv,Trump,42,56,98
2020-06-18,630,rv,Trump,80,15,95
2020-06-18,8000,a,Trump,39,53,92
2020-06-18,2300,a,Trump,77,19,96
2020-06-18,2800,a,Trump,13,85,98
2020-06-18,2300,a,Trump,27,51,78
2020-06-18,765,rv,Trump,8,89,97
2020-06-18,600,rv,Trump,33,57,90
2020-06-19,757,rv,Trump,8,88,96
2020-06-19,638,rv,Trump,29,63,92
2020-06-19,1988,rv,Trump,34,60,94
2020-06-19,1000,a,Trump,41,51,92
2020-06-21,1500,a,Trump,39,51,90
2020-06-22,951,rv,Trump,43,57,100
2020-06-22,1115,a,Trump,37,58,95
2020-06-22,1000,lv,Trump,40,60,100
2020-06-23,855,a,Trump,46,50,96
2020-06-23,2009,a,Trump,41,59,100
2020-06-23,646,a,Trump,11,89,100
2020-06-23,999,a,Trump,39,61,100
2020-06-24,1507,a,Trump,39,55,94
2020-06-25,808,rv,Trump,9,88,97
2020-06-25,1986,rv,Trump,38,56,94
2020-06-25,625,rv,Trump,79,17,96
2020-06-25,1204,rv,Trump,40,58,98
2020-06-25,8000,a,Trump,41,53,94
2020-06-25,2300,a,Trump,76,20,96
2020-06-25,2800,a,Trump,16,81,97
2020-06-25,2300,a,Trump,26,54,80
2020-06-26,1984,rv,Trump,34,60,94
2020-06-26,610,rv,Trump,74,23,97
2020-06-26,777,rv,Trump,7,89,96
2020-06-26,1000,a,Trump,45,51,96
2020-06-26,1663,lv,Trump,41,59,100
2020-06-26,867,a,Trump,40,54,94
2020-06-27,1213,a,Trump,32,54,86
2020-06-28,1500,a,Trump,37,54,91
2020-06-29,1115,a,Trump,39,56,95
2020-06-29,44557,a,Trump,43,55,98
2020-06-29,16924,a,Trump,86,14,100
2020-06-29,19899,a,Trump,8,92,100
2020-06-29,6677,a,Trump,32,66,98
2020-06-30,1011,rv,Trump,42,58,100
2020-07-01,2200,a,Trump,39,55,94
2020-07-01,709,a,Trump,79,18,97
2020-07-01,758,a,Trump,9,86,95
2020-07-01,733,a,Trump,30,61,91
2020-07-01,84793,a,Trump,86,14,100
2020-07-01,216754,a,Trump,43,55,98
2020-07-01,32211,a,Trump,31,67,98
2020-07-01,94443,a,Trump,7,93,100
2020-07-02,8000,a,Trump,37,56,93
2020-07-02,2300,a,Trump,70,26,96
2020-07-02,2800,a,Trump,13,83,96
2020-07-02,2300,a,Trump,24,51,75
2020-07-03,1000,a,Trump,41,53,94
2020-07-05,1500,a,Trump,39,57,96
2020-07-06,53106,a,Trump,44,55,99
2020-07-06,21287,a,Trump,86,13,99
2020-07-06,22410,a,Trump,7,92,99
2020-07-06,8082,a,Trump,31,67,98
2020-07-06,6155,a,Trump,44,53,97
2020-07-06,2711,a,Trump,86,13,99
2020-07-06,2537,a,Trump,8,91,99
2020-07-06,1114,a,Trump,37,57,94
2020-07-06,775,a,Trump,32,65,97
2020-07-07,2841,rv,Trump,42,58,100
2020-07-07,909,rv,Trump,76,24,100
2020-07-07,1051,rv,Trump,15,85,100
2020-07-07,824,rv,Trump,40,60,100
2020-07-07,790,a,Trump,40,57,97
2020-07-08,711,a,Trump,33,67,100
2020-07-09,1991,rv,Trump,38,57,95
2020-07-09,653,rv,Trump,78,18,96
2020-07-09,900,rv,Trump,37,59,96
2020-07-09,1002,rv,Trump,36,61,97
2020-07-09,1273,rv,Trump,35,62,97
2020-07-09,2300,a,Trump,75,23,98
2020-07-09,2800,a,Trump,14,83,97
2020-07-09,2300,a,Trump,25,57,82
2020-07-09,783,rv,Trump,12,85,97
2020-07-09,8000,a,Trump,38,56,94
2020-07-10,1258,lv,Trump,41,59,100
2020-07-10,1992,rv,Trump,36,59,95
2020-07-10,707,rv,Trump,74,23,97
2020-07-10,734,rv,Trump,8,89,97
2020-07-10,1000,a,Trump,40,54,94
2020-07-11,1504,a,Trump,38,55,93
2020-07-12,1104,rv,Trump,43,56,99
2020-07-12,1500,a,Trump,38,54,92
2020-07-12,1006,a,Trump,38,60,98
2020-07-13,50404,a,Trump,43,55,98
2020-07-13,19445,a,Trump,84,15,99
2020-07-13,21957,a,Trump,7,93,100
2020-07-13,7749,a,Trump,31,67,98
2020-07-13,1115,a,Trump,37,57,94
2020-07-14,1313,a,Trump,34,62,96
2020-07-15,4430,a,Trump,38,58,96
2020-07-16,1000,rv,Trump,40,51,91
2020-07-16,8000,a,Trump,37,56,93
2020-07-16,2300,a,Trump,72,23,95
2020-07-16,2800,a,Trump,12,85,97
2020-07-16,2300,a,Trump,22,54,76
2020-07-16,1057,a,Trump,32,68,100
2020-07-16,1015,rv,Trump,37,61,98
2020-07-17,2200,a,Trump,36,57,93
2020-07-17,655,a,Trump,77,19,96
2020-07-17,848,a,Trump,9,86,95
2020-07-17,697,a,Trump,30,57,87
2020-07-17,675,rv,Trump,73,25,98
2020-07-17,768,rv,Trump,7,90,97
2020-07-17,1000,a,Trump,38,54,92
2020-07-17,1100,a,Trump,35,58,93
2020-07-17,1000,lv,Trump,32,64,96
2020-07-17,1991,rv,Trump,34,62,96
2020-07-19,1500,a,Trump,38,54,92
2020-07-20,46450,a,Trump,43,56,99
2020-07-20,17899,a,Trump,84,15,99
2020-07-20,20826,a,Trump,7,92,99
2020-07-20,6604,a,Trump,31,67,98
2020-07-21,632,rv,Trump,77,23,100
2020-07-21,732,rv,Trump,16,84,100
2020-07-21,2008,a,Trump,43,57,100
2020-07-21,642,a,Trump,12,88,100
2020-07-21,609,a,Trump,44,55,99
2020-07-21,781,a,Trump,39,56,95
2020-07-21,1932,rv,Trump,41,59,100
2020-07-23,8000,a,Trump,38,57,95
2020-07-23,2300,a,Trump,73,23,96
2020-07-23,2800,a,Trump,11,86,97
2020-07-23,2300,a,Trump,25,61,86
2020-07-23,2200,a,Trump,35,60,95
2020-07-23,633,a,Trump,77,21,98
2020-07-23,835,a,Trump,7,89,96
2020-07-23,732,a,Trump,30,60,90
2020-07-24,1000,a,Trump,42,52,94
2020-07-24,1039,a,Trump,40,60,100
2020-07-24,1039,lv,Trump,40,60,100
2020-07-24,2842,rv,Trump,42,58,100
2020-07-24,909,rv,Trump,76,24,100
2020-07-24,1051,rv,Trump,16,84,100
2020-07-24,824,rv,Trump,39,61,100
2020-07-24,1997,rv,Trump,34,61,95
2020-07-24,696,rv,Trump,73,25,98
2020-07-24,747,rv,Trump,6,91,97
2020-07-25,1212,a,Trump,35,51,86
2020-07-26,1500,a,Trump,39,53,92
2020-07-26,613,a,Trump,35,51,86
2020-07-27,1115,a,Trump,38,56,94
2020-07-27,11001,a,Trump,37,63,100
2020-07-27,47190,a,Trump,44,55,99
2020-07-27,18749,a,Trump,86,13,99
2020-07-27,20513,a,Trump,7,92,99
2020-07-27,6804,a,Trump,32,65,97
2020-07-28,948,a,Trump,40,54,94
2020-07-28,1506,a,Trump,37,57,94
2020-07-28,878,a,Trump,12,88,100
2020-07-28,2043,a,Trump,40,60,100
2020-07-28,715,a,Trump,78,22,100
2020-07-29,730,a,Trump,34,66,100
2020-07-30,2300,a,Trump,22,60,82
2020-07-30,1031,a,Trump,36,63,99
2020-07-30,619,rv,Trump,9,90,99
2020-07-30,1407,rv,Trump,38,60,98
2020-07-30,8000,a,Trump,38,56,94
2020-07-30,2300,a,Trump,74,21,95
2020-07-30,2800,a,Trump,12,86,98
2020-07-31,2200,a,Trump,38,55,93
2020-07-31,714,a,Trump,80,15,95
2020-07-31,1000,a,Trump,41,52,93
2020-07-31,1991,rv,Trump,36,59,95
2020-07-31,681,rv,Trump,76,21,97
2020-07-31,782,rv,Trump,6,92,98
2020-07-31,660,a,Trump,31,55,86
2020-07-31,826,a,Trump,8,88,96
2020-08-01,1000,lv,Trump,38,60,98
2020-08-01,177120,a,Trump,44,54,98
2020-08-01,25284,a,Trump,34,64,98
2020-08-01,78959,a,Trump,7,92,99
2020-08-01,68037,a,Trump,87,13,100
2020-08-02,1500,a,Trump,37,55,92
2020-08-03,1115,a,Trump,38,57,95
2020-08-03,16799,a,Trump,86,13,99
2020-08-03,19927,a,Trump,8,92,100
2020-08-03,6689,a,Trump,32,66,98
2020-08-03,6282,a,Trump,42,56,98
2020-08-03,2507,a,Trump,86,13,99
2020-08-03,44601,a,Trump,42,55,97
2020-08-03,852,a,Trump,33,64,97
2020-08-03,2771,a,Trump,5,94,99
2020-08-05,2200,a,Trump,36,59,95
2020-08-05,704,a,Trump,77,18,95
2020-08-05,835,a,Trump,9,88,97
2020-08-05,661,a,Trump,27,62,89
2020-08-06,610,rv,Trump,8,92,100
2020-08-06,8000,a,Trump,38,56,94
2020-08-06,2300,a,Trump,74,21,95
2020-08-06,2800,a,Trump,11,87,98
2020-08-06,2300,a,Trump,27,52,79
2020-08-06,868,a,Trump,40,57,97
2020-08-06,1419,rv,Trump,41,58,99
2020-08-07,2143,lv,Trump,42,58,100
2020-08-07,1000,a,Trump,39,54,93
2020-08-08,2828,rv,Trump,43,57,100
2020-08-08,905,rv,Trump,76,24,100
2020-08-08,1047,rv,Trump,17,83,100
2020-08-08,820,rv,Trump,41,59,100
2020-08-09,692,rv,Trump,73,23,96
2020-08-09,812,rv,Trump,8,90,98
2020-08-09,1500,a,Trump,40,54,94
2020-08-09,1983,rv,Trump,35,61,96
2020-08-09,1000,rv,Trump,44,54,98
2020-08-09,900,rv,Trump,40,58,98
2020-08-10,1215,a,Trump,38,56,94
2020-08-10,34269,a,Trump,44,53,97
2020-08-10,13381,a,Trump,87,13,100
2020-08-10,14947,a,Trump,8,91,99
2020-08-10,4969,a,Trump,35,62,97
2020-08-11,932,a,Trump,39,57,96
2020-08-12,1108,a,Trump,38,58,96
2020-08-12,1001,a,Trump,40,59,99
2020-08-13,2800,a,Trump,12,85,97
2020-08-13,8000,a,Trump,39,55,94
2020-08-13,2300,a,Trump,76,23,99
2020-08-13,2300,a,Trump,23,53,76
2020-08-14,1994,rv,Trump,33,64,97
2020-08-14,669,rv,Trump,75,23,98
2020-08-14,770,rv,Trump,4,93,97
2020-08-14,2200,a,Trump,37,54,91
2020-08-14,680,a,Trump,77,19,96
2020-08-14,773,a,Trump,11,84,95
2020-08-14,1000,a,Trump,39,53,92
2020-08-14,1391,a,Trump,39,56,95
2020-08-14,1000,lv,Trump,36,60,96
2020-08-14,1529,a,Trump,36,59,95
2020-08-14,747,a,Trump,30,54,84
2020-08-16,1500,a,Trump,39,56,95
2020-08-17,1075,a,Trump,31,68,99
2020-08-17,1100,a,Trump,35,60,95
2020-08-17,5742,a,Trump,36,63,99
2020-08-17,42315,a,Trump,44,54,98
2020-08-17,16207,a,Trump,87,13,100
2020-08-17,19235,a,Trump,7,92,99
2020-08-19,2226,rv,Trump,42,58,100
2020-08-19,4428,a,Trump,40,56,96
2020-08-19,848,rv,Trump,8,92,100
2020-08-19,669,rv,Trump,44,56,100
2020-08-19,637,rv,Trump,86,14,100
2020-08-20,8000,a,Trump,40,53,93
2020-08-20,2300,a,Trump,77,20,97
2020-08-20,2800,a,Trump,11,86,97
2020-08-20,2300,a,Trump,27,52,79
2020-08-20,1000,a,Trump,36,58,94
2020-08-21,2362,lv,Trump,42,58,100
2020-08-21,2200,a,Trump,38,55,93
2020-08-21,704,a,Trump,80,17,97
2020-08-21,838,a,Trump,10,85,95
2020-08-21,658,a,Trump,29,56,85
2020-08-21,1992,rv,Trump,37,60,97
2020-08-21,673,rv,Trump,75,22,97
2020-08-21,800,rv,Trump,8,87,95
2020-08-21,1145,a,Trump,39,57,96
2020-08-21,1319,rv,Trump,40,59,99
2020-08-23,1500,a,Trump,42,52,94
2020-08-23,604,a,Trump,37,53,90
2020-08-24,37386,a,Trump,44,54,98
2020-08-24,14494,a,Trump,87,11,98
2020-08-24,16659,a,Trump,8,92,100
2020-08-24,5187,a,Trump,33,65,98
2020-08-24,4210,lv,Trump,46,53,99
2020-08-25,720,lv,Trump,42,57,99
2020-08-26,1012,a,Trump,39,55,94
2020-08-27,1000,a,Trump,44,51,95
2020-08-27,1001,a,Trump,40,55,95
2020-08-27,1309,rv,Trump,43,55,98
2020-08-27,8000,a,Trump,42,52,94
2020-08-27,2300,a,Trump,78,19,97
2020-08-27,2800,a,Trump,12,85,97
2020-08-27,2300,a,Trump,25,55,80
2020-08-28,1988,rv,Trump,37,59,96
2020-08-28,693,rv,Trump,76,21,97
2020-08-28,789,rv,Trump,8,88,96
2020-08-28,732,a,Trump,35,63,98
2020-08-28,1081,lv,Trump,41,57,98
2020-08-28,2200,a,Trump,36,57,93
2020-08-28,843,a,Trump,12,85,97
2020-08-28,721,a,Trump,28,59,87
2020-08-28,1335,a,Trump,42,54,96
2020-08-28,1106,a,Trump,40,55,95
2020-08-28,635,a,Trump,79,18,97
2020-08-28,1199,a,Trump,43,55,98
2020-08-29,1197,a,Trump,30,56,86
2020-08-30,1500,a,Trump,38,55,93
2020-08-31,4752,a,Trump,32,66,98
2020-08-31,1604,rv,Trump,43,57,100
2020-08-31,35847,a,Trump,44,54,98
2020-08-31,13898,a,Trump,88,11,99
2020-08-31,16297,a,Trump,7,93,100
2020-09-01,806,a,Trump,39,58,97
2020-09-01,161075,a,Trump,44,54,98
2020-09-01,61664,a,Trump,88,11,99
2020-09-01,74451,a,Trump,7,93,100
2020-09-01,20629,a,Trump,33,64,97
2020-09-02,2200,a,Trump,38,53,91
2020-09-02,672,a,Trump,80,15,95
2020-09-02,749,a,Trump,10,85,95
2020-09-02,779,a,Trump,30,57,87
2020-09-03,1202,lv,Trump,43,57,100
2020-09-03,1337,a,Trump,38,57,95
2020-09-03,867,a,Trump,37,56,93
2020-09-03,8000,a,Trump,41,53,94
2020-09-03,2300,a,Trump,78,18,96
2020-09-03,2800,a,Trump,15,83,98
2020-09-03,2300,a,Trump,23,54,77
2020-09-04,1902,lv,Trump,43,57,100
2020-09-06,1500,a,Trump,40,52,92
2020-09-06,611,a,Trump,33,51,84
2020-09-07,4668,a,Trump,33,64,97
2020-09-07,17401,a,Trump,7,93,100
2020-09-07,1311,rv,Trump,46,53,99
2020-09-07,603,rv,Trump,86,13,99
2020-09-07,642,rv,Trump,10,89,99
2020-09-07,36654,a,Trump,43,55,98
2020-09-07,13654,a,Trump,88,11,99
2020-09-08,1517,rv,Trump,43,54,97
2020-09-08,623,rv,Trump,84,15,99
2020-09-08,1523,a,Trump,38,62,100
2020-09-08,721,a,Trump,6,94,100
2020-09-08,2019,a,Trump,45,55,100
2020-09-08,718,rv,Trump,13,86,99
2020-09-09,1577,a,Trump,39,52,91
2020-09-09,2538,a,Trump,35,65,100
2020-09-10,675,a,Trump,82,13,95
2020-09-10,784,a,Trump,11,83,94
2020-09-10,741,a,Trump,29,55,84
2020-09-10,1007,rv,Trump,40,57,97
2020-09-10,2200,a,Trump,38,51,89
2020-09-10,8000,a,Trump,41,54,95
2020-09-10,2300,a,Trump,77,21,98
2020-09-10,2800,a,Trump,15,83,98
2020-09-10,2300,a,Trump,28,52,80
2020-09-11,1108,a,Trump,39,60,99
2020-09-11,1991,rv,Trump,33,62,95
2020-09-11,609,rv,Trump,76,21,97
2020-09-11,832,rv,Trump,7,90,97
2020-09-11,1000,a,Trump,40,53,93
2020-09-11,1358,a,Trump,39,58,97
2020-09-13,1500,a,Trump,40,51,91
2020-09-13,602,a,Trump,36,49,85
2020-09-13,1000,rv,Trump,40,57,97
2020-09-14,4797,a,Trump,34,64,98
2020-09-14,2000,lv,Trump,41,59,100
2020-09-14,1023,a,Trump,44,56,100
2020-09-14,36454,a,Trump,43,55,98
2020-09-14,13953,a,Trump,89,11,100
2020-09-14,16646,a,Trump,7,92,99
2020-09-15,952,a,Trump,41,55,96
2020-09-15,1288,a,Trump,40,55,95
2020-09-15,1539,a,Trump,39,55,94
2020-09-17,1100,a,Trump,33,60,93
2020-09-17,1230,rv,Trump,41,58,99
2020-09-17,8000,a,Trump,39,55,94
2020-09-17,2300,a,Trump,79,18,97
2020-09-17,2800,a,Trump,12,86,98
2020-09-17,2300,a,Trump,28,58,86
2020-09-17,1302,lv,Trump,42,56,98
2020-09-18,1430,lv,Trump,42,58,100
2020-09-18,2200,a,Trump,39,53,92
2020-09-18,801,a,Trump,10,86,96
2020-09-18,744,a,Trump,32,53,85
2020-09-18,1989,rv,Trump,38,58,96
2020-09-18,697,rv,Trump,77,21,98
2020-09-18,772,rv,Trump,9,88,97
2020-09-18,655,a,Trump,84,13,97
2020-09-18,2804,rv,Trump,45,55,100
2020-09-18,813,rv,Trump,40,60,100
2020-09-18,1350,a,Trump,40,56,96
2020-09-18,897,rv,Trump,81,19,100
2020-09-18,1037,rv,Trump,19,81,100
2020-09-19,1018,lv,Trump,41,56,97
2020-09-20,1500,a,Trump,38,55,93
2020-09-21,1008,a,Trump,40,58,98
2020-09-21,48241,a,Trump,44,53,97
2020-09-21,18465,a,Trump,89,11,100
2020-09-21,22474,a,Trump,7,92,99
2020-09-21,5954,a,Trump,33,64,97
2020-09-21,1284,rv,Trump,41,55,96
2020-09-22,1088,rv,Trump,44,54,98
2020-09-22,1297,a,Trump,42,53,95
2020-09-22,827,a,Trump,39,57,96
2020-09-23,1314,rv,Trump,47,53,100
2020-09-24,8000,a,Trump,43,50,93
2020-09-24,2300,a,Trump,78,18,96
2020-09-24,2800,a,Trump,14,82,96
2020-09-24,2300,a,Trump,28,51,79
2020-09-25,704,a,Trump,79,18,97
2020-09-25,829,a,Trump,11,85,96
2020-09-25,668,a,Trump,34,54,88
2020-09-25,1341,a,Trump,41,56,97
2020-09-25,2200,a,Trump,39,55,94
2020-09-26,1002,rv,Trump,41,57,98
2020-09-26,1000,rv,Trump,41,52,93
2020-09-27,1500,rv,Trump,41,56,97
2020-09-28,6615,a,Trump,35,63,98
2020-09-28,19144,a,Trump,89,11,100
2020-09-28,50146,a,Trump,44,53,97
2020-09-28,23015,a,Trump,6,93,99
2020-09-29,1148,rv,Trump,44,54,98
2020-09-29,882,lv,Trump,44,56,100
2020-09-29,1341,a,Trump,43,54,97
2020-10-01,688,a,Trump,34,50,84
2020-10-01,1504,rv,Trump,43,54,97
2020-10-01,1347,lv,Trump,42,55,97
2020-10-01,2200,a,Trump,40,52,92
2020-10-01,731,a,Trump,79,18,97
2020-10-01,781,a,Trump,8,88,96
2020-10-01,1205,a,Trump,37,60,97
2020-10-01,8000,a,Trump,40,54,94
2020-10-01,2300,a,Trump,76,21,97
2020-10-01,2800,a,Trump,13,85,98
2020-10-01,2300,a,Trump,27,55,82
2020-10-01,149937,rv,Trump,6,94,100
2020-10-01,129233,rv,Trump,90,9,99
2020-10-01,325970,rv,Trump,45,53,98
2020-10-01,38723,rv,Trump,35,63,98
2020-10-02,2167,lv,Trump,43,57,100
2020-10-02,1011,rv,Trump,41,57,98
2020-10-02,1328,a,Trump,38,57,95
2020-10-02,1000,a,Trump,39,56,95
2020-10-02,895,rv,Trump,37,59,96
2020-10-02,1198,rv,Trump,43,53,96
2020-10-02,1085,lv,Trump,43,53,96
2020-10-02,1005,a,Trump,41,57,98
2020-10-02,852,rv,Trump,43,56,99
2020-10-02,1000,a,Trump,36,59,95
2020-10-02,905,rv,Trump,41,56,97
2020-10-05,66877,a,Trump,43,55,98
2020-10-05,26428,a,Trump,88,12,100
2020-10-05,30404,a,Trump,6,93,99
2020-10-05,8508,a,Trump,33,66,99
2020-10-06,1078,a,Trump,41,56,97
2020-10-06,1331,a,Trump,37,59,96
2020-10-06,1136,rv,Trump,38,60,98
2020-10-06,879,rv,Trump,41,58,99
2020-10-08,2200,a,Trump,42,53,95
2020-10-08,716,a,Trump,86,12,98
2020-10-08,703,a,Trump,32,55,87
2020-10-08,1003,rv,Trump,41,58,99
2020-10-08,1121,a,Trump,33,66,99
2020-10-08,1397,a,Trump,38,59,97
2020-10-08,1199,rv,Trump,39,59,98
2020-10-08,782,a,Trump,9,89,98
2020-10-08,8000,a,Trump,40,56,96
2020-10-08,2300,a,Trump,76,20,96
2020-10-08,2800,a,Trump,12,86,98
2020-10-08,2300,a,Trump,27,54,81
2020-10-09,1525,rv,Trump,40,57,97
2020-10-09,1000,rv,Trump,41,57,98
2020-10-09,1365,lv,Trump,40,58,98
2020-10-09,1303,a,Trump,41,53,94
2020-10-10,1056,rv,Trump,12,77,89
2020-10-10,828,rv,Trump,44,56,100
2020-10-10,2855,rv,Trump,43,57,100
2020-10-10,914,rv,Trump,78,22,100
2020-10-11,1500,rv,Trump,39,56,95
2020-10-12,36618,a,Trump,6,34,40
2020-10-12,9306,a,Trump,32,66,98
2020-10-12,78524,a,Trump,44,55,99
2020-10-12,30656,a,Trump,88,12,100
2020-10-13,1342,a,Trump,39,57,96
2020-10-13,1133,rv,Trump,40,58,98
2020-10-15,2300,a,Trump,77,20,97
2020-10-15,2800,a,Trump,14,83,97
2020-10-15,2300,a,Trump,24,56,80
2020-10-15,8000,a,Trump,40,54,94
2020-10-15,1000,rv,Trump,41,57,98
2020-10-16,1583,rv,Trump,40,57,97
2020-10-16,622,rv,Trump,7,89,96
2020-10-16,1467,lv,Trump,41,57,98
2020-10-16,696,a,Trump,27,62,89
2020-10-16,1426,lv,Trump,41,57,98
2020-10-16,792,a,Trump,10,86,96
2020-10-16,711,a,Trump,80,17,97
2020-10-16,1018,a,Trump,40,59,99
2020-10-16,1346,a,Trump,39,57,96
2020-10-16,2200,a,Trump,38,56,94
2020-10-16,1006,lv,Trump,41,58,99
2020-10-17,2711,lv,Trump,43,57,100
2020-10-17,1100,a,Trump,31,61,92
2020-10-18,1500,rv,Trump,43,54,97
2020-10-18,1344,lv,Trump,42,56,98
2020-10-19,8704,a,Trump,35,63,98
2020-10-19,73903,a,Trump,44,54,98
2020-10-19,29527,a,Trump,88,12,100
2020-10-19,33795,a,Trump,6,94,100
2020-10-20,1053,a,Trump,41,56,97
2020-10-20,1214,rv,Trump,40,57,97
2020-10-20,605,rv,Trump,10,87,97
2020-10-20,1393,a,Trump,39,55,94
2020-10-22,8000,a,Trump,40,55,95
2020-10-22,2300,a,Trump,77,20,97
2020-10-22,2800,a,Trump,14,83,97
2020-10-22,2300,a,Trump,27,54,81
2020-10-23,1125,lv,Trump,45,55,100
2020-10-23,1500,rv,Trump,40,57,97
2020-10-23,642,rv,Trump,5,93,98
2020-10-23,2200,a,Trump,38,57,95
2020-10-23,1000,rv,Trump,43,50,93
2020-10-23,1302,a,Trump,37,59,96
2020-10-23,1000,rv,Trump,38,59,97
2020-10-23,1000,lv,Trump,38,57,95
2020-10-23,843,a,Trump,5,91,96
2020-10-23,688,a,Trump,80,18,98
2020-10-25,1500,rv,Trump,42,56,98
2020-10-25,1365,lv,Trump,42,56,98
2020-10-26,36805,a,Trump,88,11,99
2020-10-26,91214,a,Trump,43,54,97
2020-10-26,10077,a,Trump,33,66,99
2020-10-26,42034,a,Trump,6,94,100
2020-10-29,1000,rv,Trump,40,57,97
2020-10-29,736,a,Trump,81,16,97
2020-10-29,820,a,Trump,7,90,97
2020-10-29,644,a,Trump,31,57,88
2020-10-29,2800,a,Trump,15,83,98
2020-10-29,2300,a,Trump,30,50,80
2020-10-29,1880,lv,Trump,41,59,100
2020-10-29,2200,a,Trump,39,56,95
2020-10-29,1333,a,Trump,38,58,96
2020-10-29,8000,a,Trump,42,53,95
2020-10-29,2300,a,Trump,79,18,97
2020-10-30,1500,rv,Trump,43,55,98
2020-10-30,611,rv,Trump,8,91,99
2020-10-30,3300,lv,Trump,41,58,99
2020-10-30,1361,lv,Trump,42,57,99
2020-10-31,1500,rv,Trump,42,56,98
2020-11-05,2300,a,Trump,76,21,97
2020-11-05,8000,a,Trump,38,56,94
2020-11-05,2800,a,Trump,12,85,97
2020-11-05,2300,a,Trump,26,57,83
2020-11-06,2200,a,Trump,39,55,94
2020-11-06,830,a,Trump,8,88,96
2020-11-06,696,a,Trump,34,55,89
2020-11-06,674,a,Trump,81,16,97
2020-11-08,1500,rv,Trump,44,54,98
2020-11-08,607,rv,Trump,7,91,98
2020-11-12,2200,a,Trump,36,59,95
2020-11-12,649,a,Trump,77,19,96
2020-11-12,834,a,Trump,7,90,97
2020-11-12,718,a,Trump,31,56,87
2020-11-12,8000,a,Trump,38,56,94
2020-11-12,2300,a,Trump,74,22,96
2020-11-12,2800,a,Trump,13,84,97
2020-11-12,2300,a,Trump,23,58,81
2020-11-13,1000,rv,Trump,40,54,94
2020-11-13,1346,a,Trump,37,58,95
2020-11-13,2016,a,Trump,38,60,98
2020-11-16,1001,lv,Trump,40,57,97
2020-11-17,816,rv,Trump,16,84,100
2020-11-17,1100,a,Trump,37,57,94
2020-11-17,2205,rv,Trump,45,55,100
2020-11-17,794,rv,Trump,76,24,100
2020-11-19,2200,a,Trump,38,56,94
2020-11-19,665,a,Trump,84,14,98
2020-11-19,841,a,Trump,7,90,97
2020-11-19,694,a,Trump,32,56,88
2020-11-21,1500,rv,Trump,42,56,98
2020-11-21,634,rv,Trump,8,91,99
2020-11-26,2200,a,Trump,40,53,93
2020-11-26,706,a,Trump,80,16,96
2020-11-26,814,a,Trump,10,85,95
2020-11-26,681,a,Trump,34,54,88
2020-11-26,8000,a,Trump,38,58,96
2020-11-26,2300,a,Trump,72,25,97
2020-11-26,2800,a,Trump,15,84,99
2020-11-26,2300,a,Trump,25,58,83
2020-11-29,8000,a,Trump,39,56,95
2020-11-29,2300,a,Trump,77,22,99
2020-11-29,2800,a,Trump,15,83,98
2020-11-29,2300,a,Trump,26,56,82
2020-11-30,1113,a,Trump,36,61,97
2020-12-01,1065,a,Trump,37,59,96
2020-12-01,916,rv,Trump,37,60,97
2020-12-01,978,rv,Trump,39,58,97
2020-12-02,4419,a,Trump,37,59,96
2020-12-03,2300,a,Trump,73,24,97
2020-12-03,2800,a,Trump,14,83,97
2020-12-03,2300,a,Trump,24,55,79
2020-12-03,8000,a,Trump,37,59,96
2020-12-04,2200,a,Trump,40,55,95
2020-12-04,673,a,Trump,80,16,96
2020-12-04,885,a,Trump,11,84,95
2020-12-04,642,a,Trump,36,55,91
2020-12-06,1500,a,Trump,40,53,93
2020-12-06,609,a,Trump,40,46,86
2020-12-06,1007,rv,Trump,44,55,99
2020-12-07,3064,a,Trump,40,57,97
2020-12-07,1273,a,Trump,83,16,99
2020-12-07,1303,a,Trump,6,93,99
2020-12-09,1000,lv,Trump,47,53,100
2020-12-10,8000,a,Trump,38,57,95
2020-12-10,2300,a,Trump,76,21,97
2020-12-10,2800,a,Trump,14,84,98
2020-12-10,2300,a,Trump,25,55,80
2020-12-11,1336,a,Trump,39,56,95
2020-12-11,1000,lv,Trump,40,55,95
2020-12-13,1500,a,Trump,38,54,92
2020-12-13,1262,rv,Trump,43,54,97
2020-12-15,1122,a,Trump,44,53,97
2020-12-17,2201,a,Trump,38,56,94
2020-12-17,652,a,Trump,82,16,98
2020-12-17,916,a,Trump,13,83,96
2020-12-17,633,a,Trump,30,58,88
2020-12-17,1100,a,Trump,37,57,94
2020-12-17,8000,a,Trump,36,58,94
2020-12-17,2300,a,Trump,73,24,97
2020-12-17,2800,a,Trump,14,85,99
2020-12-17,2300,a,Trump,24,55,79
2020-12-18,1368,a,Trump,39,56,95
2020-12-19,1151,rv,Trump,43,52,95
2020-12-19,1500,a,Trump,41,50,91
2020-12-19,616,a,Trump,37,50,87
2020-12-24,2200,a,Trump,38,56,94
2020-12-24,645,a,Trump,82,16,98
2020-12-24,959,a,Trump,12,84,96
2020-12-24,8000,a,Trump,38,57,95
2020-12-24,2300,a,Trump,74,22,96
2020-12-24,2800,a,Trump,14,84,98
2020-12-24,2300,a,Trump,28,54,82
2020-12-30,3787,rv,Trump,47,53,100
2020-12-30,1363,rv,Trump,80,20,100
2020-12-30,1402,rv,Trump,19,72,91
2020-12-30,946,rv,Trump,44,56,100
2020-12-31,2200,a,Trump,39,57,96
2020-12-31,662,a,Trump,80,18,98
2020-12-31,875,a,Trump,12,85,97
2020-12-31,663,a,Trump,32,59,91
2021-01-03,1500,a,Trump,39,54,93
2021-01-04,1324,a,Trump,38,57,95
2021-01-08,2200,a,Trump,35,59,94
2021-01-08,646,a,Trump,72,24,96
2021-01-08,852,a,Trump,11,85,96
2021-01-08,701,a,Trump,28,61,89
2021-01-09,1003,a,Trump,36,62,98
2021-01-10,1500,a,Trump,38,53,91
2021-01-10,1291,rv,Trump,40,54,94
2021-01-10,1002,a,Trump,38,59,97
2021-01-11,1173,a,Trump,39,57,96
2021-01-11,1012,rv,Trump,40,56,96
2021-01-12,8000,a,Trump,42,50,92
2021-01-12,2300,a,Trump,73,21,94
2021-01-12,2800,a,Trump,18,78,96
2021-01-12,2300,a,Trump,32,45,77
2021-01-13,946,a,Trump,41,55,96
2021-01-16,1100,a,Trump,29,68,97
2021-01-16,1500,a,Trump,40,53,93
2021-01-16,601,a,Trump,11,87,98
2021-01-16,600,a,Trump,38,50,88
2021-01-20,1006,rv,Biden,59,23,82
2021-01-21,941,rv,Biden,69,31,100
2021-01-24,1500,a,Biden,52,27,79
2021-01-24,645,a,Biden,46,25,71
2021-01-27,1261,a,Biden,56,21,77
2021-01-28,1075,a,Biden,61,29,90
2021-01-29,1986,rv,Biden,61,30,91
2021-01-29,603,rv,Biden,33,58,91
2021-01-29,808,rv,Biden,89,7,96
2021-01-31,1500,a,Biden,52,32,84
2021-02-02,1163,a,Biden,56,36,92
2021-02-03,1021,a,Biden,67,31,98
2021-02-05,1000,a,Biden,52,34,86
2021-02-06,1500,a,Biden,51,32,83
2021-02-08,938,rv,Biden,65,35,100
2021-02-11,1056,a,Biden,58,32,90
2021-02-11,1067,rv,Biden,62,32,94
2021-02-12,1987,rv,Biden,60,31,91
2021-02-12,647,rv,Biden,30,63,93
2021-02-12,800,rv,Biden,88,6,94
2021-02-12,2835,rv,Biden,64,36,100
2021-02-12,1000,a,Biden,52,33,85
2021-02-12,1005,rv,Biden,57,33,90
2021-02-13,1500,a,Biden,53,32,85
2021-02-15,1874,a,Biden,62,30,92
2021-02-15,764,a,Biden,92,3,95
2021-02-17,1100,a,Biden,62,29,91
2021-02-18,1992,rv,Biden,60,33,93
2021-02-19,1500,a,Biden,53,34,87
2021-02-23,949,rv,Biden,63,37,100
2021-02-23,1778,rv,Biden,68,32,100
2021-02-23,640,rv,Biden,44,56,100
2021-02-23,658,rv,Biden,93,7,100
2021-02-25,1007,rv,Biden,60,33,93
2021-02-25,1434,a,Biden,70,29,99
2021-02-25,631,a,Biden,97,3,100
2021-02-26,1992,rv,Biden,60,30,90
2021-02-26,621,rv,Biden,31,58,89
2021-02-26,798,rv,Biden,87,9,96
2021-02-27,1500,a,Biden,52,35,87
2021-03-02,963,a,Biden,54,39,93
2021-03-03,1009,a,Biden,60,34,94
2021-03-03,1227,a,Biden,62,30,92
2021-03-04,1629,a,Biden,51,33,84
2021-03-04,605,a,Biden,87,8,95
2021-03-05,2839,a,Biden,65,35,100
2021-03-06,1500,a,Biden,51,36,87
2021-03-11,1001,rv,Biden,64,32,96
2021-03-11,1000,a,Biden,68,32,100
2021-03-12,2839,rv,Biden,65,35,100
2021-03-12,1993,rv,Biden,66,27,93
2021-03-12,618,rv,Biden,34,57,91
2021-03-12,861,rv,Biden,91,5,96
2021-03-13,1500,a,Biden,55,33,88
2021-03-15,1008,rv,Biden,55,34,89
2021-03-17,1100,a,Biden,64,31,95
2021-03-17,1310,rv,Biden,58,37,95
2021-03-20,1500,a,Biden,52,36,88
2021-03-21,1500,v,Biden,60,21,81
2021-03-22,1000,lv,Biden,53,44,97
2021-03-22,1309,a,Biden,65,28,93
2021-03-22,1167,rv,Biden,64,29,93
2021-03-23,1606,a,Biden,56,31,87
2021-03-24,696,rv,Biden,94,6,100
2021-03-24,1945,rv,Biden,71,29,100
2021-03-24,1882,rv,Biden,69,31,100
2021-03-24,677,rv,Biden,44,56,100
2021-03-25,1166,a,Biden,73,26,99
2021-03-25,2200,a,Biden,58,34,92
2021-03-25,635,a,Biden,22,72,94
2021-03-25,890,a,Biden,87,9,96
2021-03-25,676,a,Biden,54,33,87
2021-03-25,1002,rv,Biden,63,32,95
2021-03-26,2043,rv,Biden,64,30,94
2021-03-26,639,rv,Biden,32,61,93
2021-03-26,837,rv,Biden,90,7,97
2021-03-27,1256,rv,Biden,54,36,90
2021-03-27,1496,a,Biden,52,34,86
2021-04-02,1011,rv,Biden,93,7,100
2021-04-02,2732,rv,Biden,68,32,100
2021-04-02,983,rv,Biden,41,59,100
2021-04-02,683,rv,Biden,72,28,100
2021-04-03,1500,a,Biden,54,34,88
2021-04-06,1244,a,Biden,59,36,95
2021-04-06,1649,a,Biden,56,33,89
2021-04-07,1000,rv,Biden,57,31,88
2021-04-08,802,a,Biden,62,28,90
2021-04-08,1237,a,Biden,64,29,93
2021-04-08,1256,rv,Biden,62,34,96
2021-04-09,1992,rv,Biden,63,29,92
2021-04-09,621,rv,Biden,33,58,91
2021-04-09,861,rv,Biden,89,6,95
2021-04-09,3766,rv,Biden,67,33,100
2021-04-09,1356,rv,Biden,39,61,100
2021-04-09,1393,rv,Biden,94,6,100
2021-04-09,941,rv,Biden,66,34,100
2021-04-10,1500,a,Biden,54,35,89
2021-04-12,4423,a,Biden,65,29,94
2021-04-12,4423,a,Biden,64,29,93
2021-04-12,1575,a,Biden,38,56,94
2021-04-12,2070,a,Biden,90,8,98
2021-04-15,1025,rv,Biden,59,41,100
2021-04-16,1043,rv,Biden,59,33,92
2021-04-17,1500,a,Biden,52,36,88
2021-04-17,988,rv,Biden,65,31,96
2021-04-17,1100,a,Biden,64,31,95
2021-04-17,1000,a,Biden,69,27,96
2021-04-18,1002,rv,Biden,58,34,92
2021-04-18,1007,a,Biden,64,31,95
2021-04-21,1004,a,Biden,66,31,97
2021-04-22,989,rv,Biden,62,35,97
2021-04-24,1991,rv,Biden,67,26,93
2021-04-24,812,rv,Biden,95,3,98
2021-04-25,1500,a,Biden,54,34,88
2021-04-26,2819,rv,Biden,67,33,100
2021-04-26,1015,rv,Biden,41,59,100
2021-04-26,1043,rv,Biden,92,8,100
2021-04-26,705,rv,Biden,70,30,100
2021-04-27,1864,rv,Biden,69,31,100
2021-04-27,1558,a,Biden,57,32,89
2021-04-27,666,rv,Biden,44,56,100
2021-04-27,693,rv,Biden,92,8,100
2021-04-29,1842,a,Biden,71,27,98
2021-04-29,682,a,Biden,47,53,100
2021-04-29,847,a,Biden,96,3,99
2021-05-01,1500,a,Biden,52,36,88
2021-05-03,939,rv,Biden,68,32,100
2021-05-04,1249,a,Biden,66,29,95
2021-05-04,1075,rv,Biden,67,30,97
2021-05-06,1000,rv,Biden,64,31,95
2021-05-07,1994,rv,Biden,65,30,95
2021-05-07,627,rv,Biden,35,57,92
2021-05-07,830,rv,Biden,92,6,98
2021-05-08,1500,a,Biden,52,37,89
2021-05-11,1561,a,Biden,54,35,89
2021-05-14,1132,rv,Biden,64,31,95
2021-05-15,1500,a,Biden,55,35,90
2021-05-15,1613,a,Biden,59,36,95
2021-05-15,609,a,Biden,29,68,97
2021-05-15,746,a,Biden,91,7,98
2021-05-17,987,rv,Biden,64,32,96
2021-05-17,1889,rv,Biden,68,32,100
2021-05-17,680,rv,Biden,42,58,100
2021-05-17,699,rv,Biden,93,7,100
2021-05-17,1100,a,Biden,64,32,96
2021-05-18,1316,a,Biden,65,30,95
2021-05-20,1204,rv,Biden,62,34,96
2021-05-22,1500,a,Biden,55,35,90
2021-05-22,1003,rv,Biden,64,34,98
2021-05-24,1588,a,Biden,54,34,88
2021-05-25,900,lv,Biden,59,39,98
2021-05-29,1500,a,Biden,53,35,88
2021-06-04,1753,rv,Biden,52,38,90
2021-06-06,1500,a,Biden,54,35,89
2021-06-07,1885,rv,Biden,67,33,100
2021-06-07,679,rv,Biden,40,60,100
2021-06-07,697,rv,Biden,93,7,100
2021-06-10,1001,rv,Biden,62,35,97
2021-06-10,1125,a,Biden,68,31,99
2021-06-11,1994,rv,Biden,61,33,94
2021-06-11,708,rv,Biden,33,60,93
2021-06-11,761,rv,Biden,90,8,98
2021-06-11,4420,a,Biden,64,28,92
2021-06-11,1583,a,Biden,41,53,94
2021-06-11,2015,a,Biden,91,8,99
2021-06-13,1500,a,Biden,53,35,88
2021-06-17,1100,a,Biden,61,33,94
2021-06-18,1001,rv,Biden,62,30,92
2021-06-19,1001,rv,Biden,64,34,98
2021-06-20,1500,a,Biden,55,33,88
2021-06-22,1115,a,Biden,64,31,95
2021-06-22,1592,a,Biden,59,32,91
2021-06-24,1000,rv,Biden,64,33,97
2021-06-25,1989,rv,Biden,61,33,94
2021-06-25,754,rv,Biden,32,61,93
2021-06-25,778,rv,Biden,90,7,97
2021-06-26,1500,a,Biden,52,37,89
2021-06-27,907,a,Biden,62,31,93
2021-06-30,1424,a,Biden,53,24,77
2021-07-03,1500,a,Biden,55,32,87
2021-07-08,938,rv,Biden,66,34,100
2021-07-10,1500,a,Biden,52,38,90
2021-07-13,1000,lv,Biden,56,42,98
2021-07-13,1715,a,Biden,57,32,89
2021-07-13,615,a,Biden,85,9,94
2021-07-15,1500,a,Biden,56,33,89
2021-07-15,1990,rv,Biden,55,40,95
2021-07-15,1000,rv,Biden,60,35,95
2021-07-15,1308,a,Biden,66,33,99
2021-07-15,615,a,Biden,90,8,98
2021-07-16,674,rv,Biden,26,69,95
2021-07-16,1997,rv,Biden,56,38,94
2021-07-16,766,rv,Biden,86,10,96
2021-07-17,1100,a,Biden,60,35,95
2021-07-17,1500,a,Biden,52,36,88
2021-07-19,1143,rv,Biden,59,37,96
2021-07-20,949,rv,Biden,67,33,100
2021-07-24,1500,a,Biden,48,38,86
2021-07-24,802,a,Biden,53,38,91
2021-07-27,1290,a,Biden,53,40,93
2021-07-28,1322,a,Biden,53,28,81
2021-07-29,1000,rv,Biden,56,41,97
2021-07-30,1552,a,Biden,51,40,91
2021-07-31,843,a,Biden,85,11,96
2021-07-31,2200,a,Biden,56,37,93
2021-07-31,1998,rv,Biden,56,41,97
2021-07-31,712,rv,Biden,27,71,98
2021-07-31,763,rv,Biden,86,11,97
2021-07-31,650,a,Biden,28,66,94
2021-07-31,707,a,Biden,47,40,87
2021-07-31,1500,a,Biden,51,39,90
2021-08-02,1275,a,Biden,52,44,96
2021-08-02,1500,rv,Biden,51,28,79
2021-08-03,1606,rv,Biden,59,35,94
2021-08-03,763,a,Biden,53,47,100
2021-08-03,2119,a,Biden,56,44,100
2021-08-03,615,a,Biden,16,84,100
2021-08-03,742,a,Biden,92,8,100
2021-08-04,1103,rv,Biden,62,38,100
2021-08-07,1002,rv,Biden,54,42,96
2021-08-07,1500,a,Biden,47,43,90
2021-08-12,1729,a,Biden,54,45,99
2021-08-12,674,a,Biden,21,79,100
2021-08-12,795,a,Biden,86,14,100
2021-08-12,800,lv,Biden,53,40,93
2021-08-12,1001,rv,Biden,54,43,97
2021-08-13,1999,rv,Biden,53,42,95
2021-08-13,1016,rv,Biden,54,41,95
2021-08-13,4427,a,Biden,55,39,94
2021-08-13,1531,a,Biden,24,73,97
2021-08-13,698,rv,Biden,21,76,97
2021-08-13,802,rv,Biden,83,11,94
2021-08-13,2033,a,Biden,86,11,97
2021-08-14,1500,a,Biden,47,42,89
2021-08-14,1000,a,Biden,53,44,97
2021-08-16,1649,a,Biden,51,41,92
2021-08-17,992,rv,Biden,58,38,96
2021-08-17,1100,a,Biden,57,38,95
2021-08-19,2201,a,Biden,51,41,92
2021-08-19,677,a,Biden,18,76,94
2021-08-19,828,a,Biden,84,11,95
2021-08-19,696,a,Biden,45,42,87
2021-08-19,1000,rv,Biden,50,45,95
2021-08-20,711,rv,Biden,65,35,100
2021-08-20,2846,rv,Biden,61,39,100
2021-08-20,1025,rv,Biden,28,72,100
2021-08-20,1053,rv,Biden,91,9,100
2021-08-21,1500,a,Biden,47,41,88
2021-08-26,1145,rv,Biden,55,41,96
2021-08-26,1002,rv,Biden,54,43,97
2021-08-26,1241,a,Biden,55,41,96
2021-08-26,21079,a,Biden,49,31,80
2021-08-27,1003,a,Biden,55,38,93
2021-08-28,1997,rv,Biden,52,44,96
2021-08-28,721,rv,Biden,20,75,95
2021-08-28,777,rv,Biden,86,11,97
2021-08-28,1500,a,Biden,46,43,89
2021-08-29,1006,a,Biden,52,41,93
2021-08-30,1605,a,Biden,48,41,89
2021-08-30,1775,rv,Biden,53,47,100
2021-09-04,1500,a,Biden,49,31,80
2021-09-04,1500,a,Biden,42,45,87
2021-09-07,1411,a,Biden,56,43,99
2021-09-08,1803,rv,Biden,57,43,100
2021-09-08,723,rv,Biden,87,13,100
2021-09-09,995,rv,Biden,52,44,96
2021-09-10,1210,a,Biden,48,49,97
2021-09-10,958,rv,Biden,59,41,100
2021-09-12,1500,a,Biden,47,44,91
2021-09-12,1002,rv,Biden,55,44,99
2021-09-14,3201,a,Biden,47,44,91
2021-09-14,769,a,Biden,18,78,96
2021-09-14,1092,a,Biden,81,13,94
2021-09-14,956,a,Biden,41,50,91
2021-09-15,1005,a,Biden,48,46,94
2021-09-16,728,a,Biden,59,41,100
2021-09-16,2508,a,Biden,56,42,98
2021-09-16,737,a,Biden,16,84,100
2021-09-16,813,a,Biden,90,10,100
2021-09-17,1100,a,Biden,59,37,96
2021-09-17,1005,rv,Biden,53,42,95
2021-09-18,1998,rv,Biden,49,45,94
2021-09-18,650,rv,Biden,17,80,97
2021-09-18,775,rv,Biden,80,14,94
2021-09-18,1500,a,Biden,46,42,88
2021-09-19,1500,a,Biden,49,28,77
2021-09-23,1099,a,Biden,57,43,100
2021-09-23,1000,rv,Biden,51,47,98
2021-09-24,1101,a,Biden,57,42,99
2021-09-26,1500,a,Biden,43,46,89
2021-09-27,935,rv,Biden,52,37,89
2021-09-29,1308,a,Biden,45,32,77
2021-10-01,1326,a,Biden,48,50,98
2021-10-01,1640,a,Biden,47,44,91
2021-10-02,694,rv,Biden,19,79,98
2021-10-02,745,rv,Biden,82,13,95
2021-10-02,1998,rv,Biden,49,46,95
2021-10-03,1500,a,Biden,45,45,90
2021-10-05,1500,rv,Biden,46,32,78
2021-10-05,601,rv,Biden,77,6,83
2021-10-07,1001,rv,Biden,52,45,97
2021-10-09,1500,a,Biden,45,46,91
2021-10-11,1200,rv,Biden,51,43,94
2021-10-13,915,a,Biden,46,44,90
2021-10-14,800,a,Biden,50,45,95
2021-10-15,1098,rv,Biden,55,42,97
2021-10-16,1003,rv,Biden,51,46,97
2021-10-16,1998,rv,Biden,49,45,94
2021-10-16,693,rv,Biden,19,78,97
2021-10-16,777,rv,Biden,82,14,96
2021-10-16,1500,a,Biden,43,45,88
2021-10-17,1500,rv,Biden,50,32,82
2021-10-17,1100,a,Biden,52,44,96
2021-10-17,1000,rv,Biden,51,45,96
2021-10-19,1704,a,Biden,45,45,90
2021-10-20,2727,rv,Biden,45,40,85
2021-10-20,981,rv,Biden,18,71,89
2021-10-20,1010,rv,Biden,77,9,86
2021-10-20,682,rv,Biden,37,45,82
2021-10-21,1083,a,Biden,54,45,99
2021-10-22,1001,rv,Biden,50,47,97
2021-10-23,1000,a,Biden,51,47,98
2021-10-24,1500,a,Biden,45,45,90
2021-10-24,1990,rv,Biden,47,47,94
2021-10-27,1688,rv,Biden,50,44,94
2021-10-27,607,rv,Biden,23,72,95
2021-10-27,635,rv,Biden,82,14,96
2021-10-30,1500,a,Biden,45,46,91
2021-10-30,1996,rv,Biden,49,44,93
2021-10-30,713,rv,Biden,21,74,95
2021-10-30,724,rv,Biden,80,16,96
2021-10-31,1500,rv,Biden,49,36,85
2021-11-01,800,lv,Biden,51,46,97
2021-11-01,815,a,Biden,49,49,98
2021-11-03,1000,rv,Biden,43,50,93
2021-11-04,1003,rv,Biden,52,45,97
2021-11-04,1673,a,Biden,48,43,91
2021-11-06,1500,a,Biden,44,44,88
2021-11-07,1001,a,Biden,47,49,96
2021-11-08,1820,a,Biden,44,48,92
2021-11-11,1378,a,Biden,45,50,95
2021-11-12,1013,rv,Biden,52,43,95
2021-11-13,1998,rv,Biden,48,47,95
2021-11-13,686,rv,Biden,14,81,95
2021-11-13,781,rv,Biden,79,16,95
2021-11-14,1500,a,Biden,45,48,93
2021-11-14,1003,rv,Biden,48,49,97
2021-11-15,1500,rv,Biden,45,37,82
2021-11-17,1696,a,Biden,47,46,93
2021-11-17,1100,a,Biden,47,48,95
2021-11-18,1000,rv,Biden,51,46,97
2021-11-20,1500,a,Biden,43,47,90
2021-11-27,1500,a,Biden,44,44,88
2021-11-30,1172,a,Biden,50,44,94
2021-12-01,1301,a,Biden,43,36,79
2021-12-01,800,a,Biden,46,48,94
2021-12-02,1089,a,Biden,57,42,99
2021-12-03,1000,rv,Biden,51,46,97
2021-12-04,2000,rv,Biden,50,45,95
2021-12-04,687,rv,Biden,19,78,97
2021-12-04,785,rv,Biden,84,13,97
2021-12-04,1500,a,Biden,42,47,89
2021-12-05,1500,rv,Biden,41,40,81
2021-12-05,1000,lv,Biden,42,55,97
2021-12-08,1200,rv,Biden,45,48,93
2021-12-08,1256,a,Biden,54,45,99
2021-12-09,1020,rv,Biden,52,43,95
2021-12-09,1558,a,Biden,45,45,90
2021-12-11,1002,rv,Biden,47,49,96
2021-12-12,1500,a,Biden,43,46,89
2021-12-13,4407,a,Biden,52,43,95
2021-12-13,1592,a,Biden,23,75,98
2021-12-13,2048,a,Biden,81,17,98
2021-12-13,1990,rv,Biden,47,47,94
2021-12-17,777,lv,Biden,51,46,97
2021-12-17,1100,a,Biden,50,46,96
2021-12-17,1895,rv,Biden,45,55,100
2021-12-18,1500,rv,Biden,44,38,82
2021-12-18,1998,rv,Biden,48,47,95
2021-12-18,708,rv,Biden,17,78,95
2021-12-18,759,rv,Biden,85,12,97
2021-12-19,1500,a,Biden,42,47,89
2021-12-27,1000,rv,Biden,47,47,94
2022-01-02,1500,a,Biden,42,47,89
2022-01-02,1000,rv,Biden,49,42,91
2022-01-04,1200,a,Biden,44,50,94
2022-01-05,1308,a,Biden,41,39,80
2022-01-06,1000,rv,Biden,49,47,96
2022-01-06,1000,rv,Biden,44,52,96
2022-01-07,1313,a,Biden,39,55,94
2022-01-08,2000,rv,Biden,44,51,95
2022-01-08,1500,rv,Biden,41,40,81
2022-01-08,771,rv,Biden,78,20,98
2022-01-08,719,rv,Biden,15,83,98
2022-01-08,1500,a,Biden,43,48,91
2022-01-10,1013,rv,Biden,46,54,100
2022-01-10,1527,a,Biden,45,54,99
2022-01-13,1161,a,Biden,45,54,99
2022-01-13,1161,a,Biden,45,54,99
2022-01-14,1000,a,Biden,44,53,97
2022-01-15,1500,a,Biden,40,51,91
2022-01-16,1001,rv,Biden,46,52,98
2022-01-17,1100,a,Biden,40,55,95
2022-01-19,1815,rv,Biden,44,50,94
2022-01-19,718,rv,Biden,20,76,96
2022-01-19,672,rv,Biden,71,23,94
2022-01-20,1000,rv,Biden,50,48,98
2022-01-20,1568,a,Biden,43,50,93
2022-01-21,1029,rv,Biden,51,46,97
2022-01-22,2005,rv,Biden,44,50,94
2022-01-22,758,rv,Biden,75,20,95
2022-01-22,1500,a,Biden,38,51,89
2022-01-22,712,rv,Biden,16,80,96
2022-01-29,1500,a,Biden,41,50,91
2022-01-29,1500,a,Biden,44,47,91
2022-01-31,4404,a,Biden,47,48,95
2022-01-31,1663,a,Biden,20,77,97
2022-01-31,2015,a,Biden,75,22,97
2022-02-01,1008,a,Biden,47,52,99
2022-02-02,1355,a,Biden,37,40,77
2022-02-03,1628,a,Biden,43,50,93
2022-02-03,1000,rv,Biden,48,48,96
2022-02-03,800,lv,Biden,50,44,94
2022-02-05,747,rv,Biden,17,81,98
2022-02-05,762,rv,Biden,76,20,96
2022-02-05,2005,rv,Biden,45,50,95
2022-02-06,1500,rv,Biden,42,38,80
2022-02-10,1321,a,Biden,43,53,96
2022-02-12,1500,a,Biden,40,49,89
2022-02-15,1000,rv,Biden,48,44,92
2022-02-15,1264,a,Biden,47,49,96
2022-02-16,1000,rv,Biden,46,48,94
2022-02-17,1100,a,Biden,44,51,95
2022-02-17,1770,rv,Biden,48,49,97
2022-02-17,655,rv,Biden,15,83,98
2022-02-17,761,rv,Biden,81,17,98
2022-02-19,1500,a,Biden,42,48,90
2022-02-19,1001,rv,Biden,47,51,98
2022-02-19,689,rv,Biden,17,80,97
2022-02-19,2005,rv,Biden,45,48,93
2022-02-19,803,rv,Biden,76,18,94
2022-02-19,1078,rv,Biden,51,44,95
2022-02-20,1011,a,Biden,44,50,94
2022-02-23,1500,rv,Biden,45,32,77
2022-02-23,2026,rv,Biden,44,50,94
2022-02-23,729,rv,Biden,18,78,96
2022-02-23,750,rv,Biden,73,24,97
2022-02-24,1532,a,Biden,44,47,91
2022-02-26,1500,a,Biden,46,44,90
2022-03-01,1322,a,Biden,55,43,98
2022-03-01,1017,a,Biden,53,47,100
2022-03-02,1318,a,Biden,43,36,79
2022-03-03,1000,rv,Biden,52,45,97
2022-03-04,2005,rv,Biden,49,45,94
2022-03-04,683,rv,Biden,19,76,95
2022-03-04,794,rv,Biden,81,12,93
2022-03-05,1500,a,Biden,47,43,90
2022-03-08,1500,rv,Biden,47,34,81
2022-03-08,603,rv,Biden,74,10,84
2022-03-10,1623,a,Biden,47,44,91
2022-03-10,1936,a,Biden,49,44,93
2022-03-10,697,a,Biden,47,45,92
2022-03-11,622,a,Biden,56,42,98
2022-03-11,2000,rv,Biden,50,50,100
2022-03-12,1500,a,Biden,43,46,89
2022-03-15,1002,a,Biden,47,44,91
2022-03-17,1100,a,Biden,46,49,95
2022-03-17,1000,rv,Biden,50,45,95
2022-03-17,1082,a,Biden,53,46,99
2022-03-18,1050,lv,Biden,51,43,94
2022-03-18,2005,rv,Biden,49,46,95
2022-03-18,729,rv,Biden,16,80,96
2022-03-18,741,rv,Biden,82,14,96
2022-03-18,1004,rv,Biden,50,48,98
2022-03-18,1000,a,Biden,51,46,97
2022-03-19,1500,a,Biden,45,44,89
2022-03-20,1500,rv,Biden,47,35,82
2022-03-26,1500,a,Biden,44,46,90
2022-03-31,1436,a,Biden,48,47,95
2022-03-31,1618,a,Biden,47,44,91
2022-03-31,998,rv,Biden,51,45,96
2022-04-01,1990,rv,Biden,44,51,95
2022-04-02,1500,a,Biden,43,45,88
2022-04-03,1500,rv,Biden,48,35,83
2022-04-06,1308,a,Biden,46,33,79
2022-04-09,1500,a,Biden,49,41,90
2022-04-14,997,rv,Biden,52,45,97
2022-04-14,1085,a,Biden,50,49,99
2022-04-15,2005,rv,Biden,49,43,92
2022-04-15,687,rv,Biden,16,79,95
2022-04-15,782,rv,Biden,79,11,90
2022-04-16,1500,a,Biden,44,44,88
2022-04-18,1500,rv,Biden,45,36,81
2022-04-18,1100,a,Biden,44,49,93
2022-04-18,1001,lv,Biden,52,43,95
2022-04-19,1377,a,Biden,53,42,95
2022-04-19,1605,a,Biden,48,43,91
2022-04-20,1699,rv,Biden,52,43,95
2022-04-20,708,rv,Biden,25,73,98
2022-04-20,727,rv,Biden,83,14,97
2022-04-21,1554,a,Biden,46,48,94
2022-04-24,1004,a,Biden,51,43,94
2022-04-26,1500,a,Biden,45,43,88
2022-04-28,1003,rv,Biden,49,47,96
2022-04-28,1007,a,Biden,51,48,99
2022-04-28,999,rv,Biden,52,45,97
2022-04-29,2000,rv,Biden,47,48,95
2022-04-29,713,rv,Biden,18,80,98
2022-04-29,774,rv,Biden,80,16,96
2022-04-30,1500,a,Biden,46,43,89
2022-05-01,1500,rv,Biden,45,35,80
2022-05-03,1577,a,Biden,47,45,92
2022-05-04,1320,a,Biden,42,35,77
2022-05-05,1000,a,Biden,59,35,94
2022-05-08,1500,a,Biden,44,44,88
2022-05-12,1586,a,Biden,48,47,95
2022-05-12,634,a,Biden,48,47,95
2022-05-12,1172,a,Biden,53,47,100
2022-05-13,2005,rv,Biden,49,46,95
2022-05-13,693,rv,Biden,17,77,94
2022-05-13,748,rv,Biden,81,15,96
2022-05-15,1500,a,Biden,45,43,88
2022-05-17,1500,rv,Biden,46,33,79
2022-05-17,1100,a,Biden,41,52,93
2022-05-18,1963,rv,Biden,52,43,95
2022-05-18,720,rv,Biden,26,70,96
2022-05-18,709,rv,Biden,83,14,97
2022-05-19,1573,a,Biden,47,46,93
2022-05-19,607,a,Biden,75,20,95
2022-05-19,998,rv,Biden,49,47,96
2022-05-20,1020,lv,Biden,54,40,94
2022-05-21,1500,a,Biden,44,44,88
2022-05-28,1500,a,Biden,43,44,87
2022-05-30,613,rv,Biden,72,11,83
2022-05-30,1500,rv,Biden,43,36,79
2022-06-03,1576,a,Biden,47,46,93
2022-06-04,2006,rv,Biden,47,46,93
2022-06-04,712,rv,Biden,16,80,96
2022-06-04,687,rv,Biden,78,15,93
2022-06-04,607,rv,Biden,47,40,87
2022-06-04,1500,a,Biden,44,42,86
2022-06-09,998,rv,Biden,50,47,97
2022-06-10,1541,a,Biden,46,46,92
2022-06-11,1500,a,Biden,44,43,87
2022-06-15,1500,rv,Biden,39,37,76
2022-06-17,1030,lv,Biden,52,41,93
2022-06-17,2004,rv,Biden,48,45,93
2022-06-17,715,rv,Biden,19,75,94
2022-06-17,755,rv,Biden,80,16,96
2022-06-17,1524,a,Biden,50,44,94
2022-06-18,1500,a,Biden,44,43,87
2022-06-23,1053,a,Biden,53,45,98
2022-06-23,1200,rv,Biden,50,46,96
2022-06-24,1630,a,Biden,45,43,88
2022-06-29,1311,rv,Biden,50,44,94
2022-07-06,1643,a,Biden,42,35,77
2022-07-08,2005,rv,Biden,48,47,95
2022-07-08,708,rv,Biden,16,77,93
2022-07-08,792,rv,Biden,78,19,97
2022-07-08,1672,a,Biden,47,42,89
2022-07-09,1500,rv,Biden,41,35,76
2022-07-14,1523,a,Biden,50,43,93
2022-07-14,1002,rv,Biden,52,43,95
2022-07-15,1022,lv,Biden,52,42,94
2022-07-16,1500,a,Biden,42,44,86
2022-07-22,2006,rv,Biden,46,48,94
2022-07-22,688,rv,Biden,15,79,94
2022-07-22,734,rv,Biden,79,15,94
2022-07-27,1885,rv,Biden,48,47,95
2022-07-27,679,rv,Biden,23,74,97
2022-07-27,697,rv,Biden,79,18,97
2022-07-28,1557,a,Biden,46,44,90
2022-07-28,1007,rv,Biden,51,46,97
2022-07-29,1500,rv,Biden,43,32,75
2022-08-02,1335,a,Biden,42,37,79
2022-08-03,1000,a,Biden,38,42,80
2022-08-05,665,a,Biden,56,44,100
2022-08-05,2005,rv,Biden,49,46,95
2022-08-05,696,rv,Biden,17,78,95
2022-08-05,751,rv,Biden,83,14,97
2022-08-07,1500,a,Biden,43,45,88
2022-08-11,1000,rv,Biden,51,46,97
2022-08-13,1500,a,Biden,47,43,90
2022-08-17,1500,rv,Biden,42,36,78
2022-08-17,605,rv,Biden,70,14,84
2022-08-18,1563,a,Biden,46,44,90
2022-08-19,2005,rv,Biden,49,46,95
2022-08-19,707,rv,Biden,18,78,96
2022-08-19,791,rv,Biden,81,16,97
2022-08-19,1054,lv,Biden,51,44,95
2022-08-20,1500,a,Biden,45,42,87
2022-08-25,1584,a,Biden,50,45,95
2022-08-26,1000,rv,Biden,50,46,96
2022-08-28,1500,rv,Biden,46,37,83
2022-08-28,603,rv,Biden,76,11,87
2022-08-28,1500,a,Biden,45,44,89
2022-09-01,2523,a,Biden,53,44,97
2022-09-02,1634,a,Biden,46,42,88
2022-09-03,1982,a,Biden,55,44,99
2022-09-03,634,a,Biden,23,77,100
2022-09-03,654,a,Biden,87,13,100
2022-09-03,694,a,Biden,55,45,100
2022-09-06,1003,a,Biden,52,41,93
2022-09-07,1854,rv,Biden,49,44,93
2022-09-07,672,rv,Biden,78,16,94
2022-09-07,1277,a,Biden,45,34,79
2022-09-07,667,rv,Biden,24,73,97
2022-09-08,1001,rv,Biden,53,44,97
2022-09-09,2006,rv,Biden,49,45,94
2022-09-09,681,rv,Biden,14,78,92
2022-09-09,793,rv,Biden,83,14,97
2022-09-09,1054,a,Biden,55,43,98
2022-09-14,1500,rv,Biden,43,37,80
2022-09-14,603,rv,Biden,72,13,85
2022-09-16,1056,lv,Biden,51,43,94
2022-09-21,806,a,Biden,50,47,97
2022-09-22,997,rv,Biden,51,45,96
2022-09-23,2005,rv,Biden,47,46,93
2022-09-23,740,rv,Biden,19,76,95
2022-09-23,751,rv,Biden,88,16,104
2022-09-23,1556,a,Biden,47,43,90
2022-10-06,1121,a,Biden,55,44,99
2022-10-06,1000,rv,Biden,51,45,96
2022-10-07,777,rv,Biden,82,13,95
2022-10-07,2006,rv,Biden,50,44,94
2022-10-07,686,rv,Biden,21,75,96
2022-10-12,1500,rv,Biden,43,35,78
2022-10-12,2010,rv,Biden,51,45,96
2022-10-12,724,rv,Biden,25,72,97
2022-10-12,744,rv,Biden,82,16,98
2022-10-13,1629,a,Biden,48,42,90
2022-10-20,1000,rv,Biden,52,44,96
2022-10-24,1014,lv,Biden,49,46,95
2022-10-27,1641,a,Biden,47,42,89
2022-11-03,2210,a,Biden,48,43,91
2022-11-03,677,a,Biden,15,78,93
2022-11-03,878,a,Biden,82,13,95
2022-11-03,655,a,Biden,35,48,83
2022-11-10,2210,a,Biden,49,42,91
2022-11-10,683,a,Biden,17,77,94
2022-11-10,896,a,Biden,80,14,94
2022-11-10,631,a,Biden,39,45,84
2022-11-17,2210,a,Biden,47,45,92
2022-11-17,674,a,Biden,16,79,95
2022-11-17,885,a,Biden,81,13,94
2022-11-17,651,a,Biden,35,50,85
2022-11-17,1036,lv,Biden,49,44,93
2022-11-18,2018,rv,Biden,50,44,94
2022-11-18,717,rv,Biden,19,75,94
2022-11-18,792,rv,Biden,80,16,96
2022-11-19,1500,a,Biden,38,38,76
